Map:
------------
------------
------------
------------
--00---00---
-0--0-0--0--
--0--0--0---
---0---0----
----0-0-----
-----0------
------------
------------
------------
------------
------------
------------
------------
------------
------------
------------
------------
------------
------------
------------
------------
Map/

Meta:
Name: LEVEL 4
Time: 300
Hardened: #
PowerUp: 2
Meta/

Legend:
%) blue-block.png
0) grey-block.png
1) orange-block.png
a) purple-block.png
Legend/